xxxxxxxxxxxxxxxxxxxx\
x                  x\
x     x        x   x\
x     x            x\
x xxxxx            x\
x                  x\
x                  x\
x                  x\
x                  x\
x                  x\
x                  x\
x                  x\
x                  x\
x                  x\
x                  x\
x                  x\
x                  x\
x   x          x   x\
x                  x\
xxxxxxxxxxxxxxxxxxxx\